5 9 2
0 0 0 0 0 0 0 0 0
3 1 1 1 1 1 1 1 2
0 0 0 0 0 0 0 0 0
3 1 1 1 1 1 1 1 2
0 0 0 0 0 0 0 0 0
1 8 1 7 1 6 1 5 1 4 1 3 1 2 1 1 1 0 -1 -1
3 8 3 7 3 6 3 5 3 4 3 3 3 2 3 1 3 0 -1 -1