9 10 1
0 0 0 0 0 0 0 0 0 0
3 1 1 0 1 1 1 0 1 2
0 0 1 0 1 0 1 0 1 0
0 0 1 0 1 0 1 0 1 0
0 0 1 0 1 0 1 0 1 0
0 0 1 0 1 0 1 0 1 0
0 0 1 0 1 0 1 0 1 0
0 0 1 1 1 0 1 1 1 0
0 0 0 0 0 0 0 0 0 0
1 9 1 8 2 8 3 8 4 8 5 8 6 8 7 8 7 7 7 6 6 6 5 6 4 6 3 6 2 6 1 6 1 5 1 4 2 4 3 4 4 4 5 4 6 4 7 4 7 3 7 2 6 2 5 2 4 2 3 2 2 2 1 2 1 1 1 0 -1 -1